NO ./mursxpm/128_1.xpm
SO ./mursxpm/128_2.xpm
WE ./mursxpm/128_3.xpm
EA ./mursxpm/128_4.xpm
C 252,253,255
F 252,253,255

1111111111
1000000001
100N000001
10000000N1
1111111111
