1  1111111111111111111111
1100100000000010000011111
100011100000001000001111
1000001000W000111110111
1000001000000000000011
111110000001000000001
100000000000000000001
111111111111111111111