
NO ./mursxpm/128_1.xpm
SO ./mursxpm/128_2.xpm
WE ./mursxpm/128_3.xpm
EA ./mursxpm/128_4.xpm

F 209,237,179
C 169,233,241

1111111111111111111111
1100100000000010000011111
100011100000001000001111
1000001000W000111110111
1000001000000000000011
111110000001000000001
100000000000000000001
111111111111111111111