NO ./mursxpm/128_1.xpm
SO ./mursxpm/128_2.xpm
WE ./mursxpm/128_3.xpm
EA ./mursxpm/128_4.xpm

F 220,100,0
C 255,30,0


111111
10N001
100111
1001
1111